R 600 500

NO ./textures/new.xpm
SO ./textures/texture_metal.xpm
EA ./textures/texture_wood.xpm
WE ./textures/texture_stone.xpm
S ./textures/end.xpm

F 200,100,0
C 0,100,200

111111111111111111111111111111
112111111111000000011110000001
100011110011000100011111110001
100011100011000002220000011111
111110111000000000000000000001
100000000111000002211111111001
100000002111000000011110000001
100111111111100111000110000001
100111111111100111110110011111
100111111111100000000110011111
100000011000000000000110000001
10000000000000S000000110000001
111111000011100000000110000001
1111111100111111111000000001111
10011111001      11000000001111 1
100000000011111111111000011011
110000000011100000000011000011
111111111111111111111111111111
