R 1020 756

NO ./textures/texture_bricks.xpm
SO ./textures/texture_metal.xpm
WE ./textures/texture_stone.xpm
EA ./textures/texture_wood.xpm

S ./textures/end.xpm
F 200,100,0
C 0,100,200

1111111111111111
10S0120000001001
1000110110100001
1000000100011101
1011101101000101
1000100001110101
1011111100010101
1000000000000001
1111111111111111
