R 2000 1000

NO ./textures/beach.xpm
SO ./textures/beach.xpm
WE ./textures/beach.xpm
EA ./textures/beach.xpm

S ./textures/harry.xpm


C 79,217,253
F 81,198,254

111111111111
100000000001
102000000001
1020020000W1
100000000001
100000000001
100000000001
100200000001
100000000001
100000000001
100000000001
111111111111