R 900 600
SO ./textures/t_beach.xpm
NO ./textures/t_beach.xpm

WE ./textures/t_beach.xpm
EA ./textures/t_beach.xpm
S ./textures/sp_1.xpm

F  20,160,190
C 75,220,250


1111111111111111
1000000000000001
100000W000000001
1000000002000001
1000000000000001
100020000001111
100020000001
100020000001
100200000001
100000000001
100000000001
100000000001
100000000001
100200000001
100020000001
100002000001
100000000001
100000000001
100000000001
100000002201
100000000001
111111111111
