R 900 600
SO ./textures/t_metal.xpm
NO ./textures/t_beach.xpm

WE ./textures/t_beach.xpm
EA ./textures/t_beach.xpm
S ./textures/sp_1.xpm

F 65,0,250
C 81,198,254

1111111111111111
1000000000000001
1000000000000001
1000000000000001
100000200E000001
100020000001111
100020010001
100020000001
100200000001
100000000001
100000000001
100000000001
100000000001
111111111111
