R 2000 1000

NO ./textures/t_beach.xpm
SO ./textures/t_beach.xpm
WE ./textures/t_beach.xpm
EA ./textures/t_beach.xpm

S ./textures/sp_1.xpm


C 79,217,253
F 81,198,254

111111111111
100000000001
100020000001
100020000001
100020010001
100020000001
1002000000W1
100000000001
100000000001
100000000001
100000000001
111111111111