R 1600 1300

NO ./textures/t_beach.xpm
SO ./textures/t_beach.xpm
WE ./textures/t_beach.xpm
EA ./textures/t_beach.xpm

S ./textures/sp_0.xpm


C 79,217,253
F 81,198,254

111111111111
100000000001
100002000001
100000000001
100000000001
102000002001
1000W0000001
100000000001
100002000001
100000000001
100000000001
111111111111