R 900 600

NO ./textures/texture_wood.xpm
SO ./textures/texture_metal.xpm
WE ./textures/beach.xpm
EA ./textures/beach.xpm

S ./minilibX/test/open30.xpm


C 100,200,255
F 69,99,56

1111111111111111
1000000000000001
10E0000000000001
1000000200000011
1000000000011111
1000000000000001
1000000000200001
1000000000000001
1111111111111111