R 2000 1000

NO ./textures/t_wood.xpm
SO ./textures/t_wood.xpm
WE ./textures/t_wood.xpm
EA ./textures/t_wood.xpm

S ./textures/sp_0.xpm


C 255,255,255
F 0,0,0

1111111111111
1000000000001
1000002000001
1000000000001
1000000000001
1000000000001
102000N000201
1000000000001
1000000000001
1000000000001
1000002000001
1000000000001
1111111111111
