R 900 600

NO ./textures/t_wood.xpm
SO ./textures/t_beach.xpm
WE ./textures/t_purple.xpm
EA ./textures/t_beach.xpm

S ./minilibX/test/open30.xpm


C 100,200,255
F 69,99,56

1111111111111111
1000000000000001
10E0000200000001
1000000200000011
1000000000011111
1000000000000001
1000000000000001
1000000000000001
1111111111111111