R 2000 1000

NO ./textures/t_beach.xpm
SO ./textures/t_beach.xpm
WE ./textures/t_beach.xpm
EA ./textures/t_beach.xpm

S ./textures/sp_0.xpm


C 79,217,253
F 81,198,254

111111111
100000001
100020001
100000001
1020N0201
100000001
100020001
100000001
111111111
