R 1000 1200

  NO  ./textures/t_wood.xpm
WE ./textures/t_stone.xpm

SO ./textures/t_stone.xpm
EA ./textures/t_stone.xpm
S ./textures/sp_1.xpm


F  101 , 34 , 25
C  101 , 34 , 25 

11111111
10N00001
11211101
10000001
10000001
11111111
