R 2000 1000

NO ./textures/texture_wood.xpm
SO ./textures/texture_wood.xpm
WE ./textures/texture_wood.xpm
EA ./textures/texture_wood.xpm

S ./textures/new.xpm


C 79,217,253
F 81,198,254

1111111111111
1000000000001
1000002000001
1000000000001
1000000000001
1000000000001
102000N000201
1000000000001
1000000000001
1000000000001
1000002000001
1000000000001
1111111111111
