

S ./textures/sp_0.xpm
F 255,255,255
C 255,255,255


WE ./textures/t_stone2.xpm
SO ./textures/t_purple.xpm
EA ./textures/t_wood.xpm

R 900 500
NO ./textures/t_beach.xpm

1111111
 111111111111
100000000000011
102000000001001
1000N000001 11
100002000001001
 1111111111111
1 1111111