R 750 500

NO ./textures/t_bricks.xpm
SO ./textures/t_metal.xpm
WE ./textures/t_stone.xpm
EA ./textures/t_wood.xpm

S ./textures/sp_3.xpm
F 200,100,0
C 0,100,200

    111111111111111111111111111111
    112111111111000000011110000001
    100000000000000S00011111110001
    100011100011000000000000011111
111110111000000222222220000001
100000000111000000011111111001
100000000111000000011110000001
100111111111100111000110000001
10011    111100111110110011111
100111111111100000000110011111  1
100000011000000000000110000001
100000000000000000000110200001
111111000011100000000110000001
11111111001 100000000110000001
10011111001 100000000111111011
10000000001 111110111000011011111
10000000001 100000000011000011
11111111111 111111111111111111
