R 900 600

NO ./textures/beach.xpm
SO ./textures/beach.xpm
WE ./textures/beach.xpm
EA ./textures/beach.xpm

S ./textures/harry.xpm


C 100,200,255
F 80,150,250

111111111
100000001
1000W0001
100000001
100200001
111111111