R 9900 9600

NO ./textures/texture_wood.xpm
SO ./textures/texture_metal.xpm
WE ./textures/texture_stone.xpm
EA ./textures/texture_stone.xpm
S ./textures/end.xpm

C 80,180,255
F 69,99,56

111111
100101
102001
1100N1
111111